1111111111
100P0000E1
1111111111
