11111111111
1000C0000E1
10000000001
10000000001
1000000C001
11111111111
